#T#############
#TTTT         #
####T## ##  # #
#   TTTT#   # #
# #####T   ## #
# #D   T      #
# ###  T### D #
# #   #T#   # #
# # ###T#   # #
# # #  T# #   #
#   ###T# # ###
# D    TTTT # #
# #####  #T # #
#         TTTT#
#############T#
