#T#####
#T    #
#T#####
#T    #
#T### #
#TTTTT#
#####T#
