#T#############
#TTT          #
#T#T## D# #   #
#D T    # # # #
###T# ##  ##  #
#  T  # #     #
###T#   ##  # #
# #T# # #     #
# #T# # # ##D##
#  TTT  #     #
##   T# #   # #
# #  TTTTD# # #
# ####TTT#  # #
#    DTTTTTTTT#
#############T#
