#T#######################
#TTTT              DDDDD#
#DDDTDDDDDDDDDDDDD DDDDD#
#D  TT     DDDDDDD DDDDD#
#D  TTTT   DDDDDDD DDDDD#
#D     TT  DDDDDDD DDDDD#
#D      TT DDDDDDD DDDDD#
#D       TTDDDDDDD DDDDD#
#DDDDDDDDTDDDDDDDD DDDDD#
#DDDDDDD TT   DDDD DDDDD#
#DDDDDDD  T   DDDD DDDDD#
#DDDDDDD TT   DDDD DDDDD#
#DDDDDDDTTT   DDDD DDDDD#
#DDDDDDDTTT   DDDD DDDDD#
#DDDDDDDTDDDDDDDDD DDDDD#
#D      TTTDDDDDDD DDDDD#
#D      TTDDDDDDDD DDDDD#
#D      TTDDD    D D    #
#D      T DDD    D D    #
#D      TTDDD    D D    #
#DDDTTTTTTDDDDDDDD D    #
#DD T              D    #
#D  TTTDDDDDDTTTTTTTDDDD#
#DD  TTTTTTTTTTT TTTTTTT#
#######################T#
