#T#######################
#TTTTTTTTTTTTTTTTT DDDDD#
#TTDDDDDDDDDDTDTDT DDDDD#
#D         DDDDDDTTDDDDD#
#D         DDDDDDTTDDDDD#
#D         DDDDDDTTDDDDD#
#D         DDDDDDDTDDDDD#
#D         DDDDDDDTDDDDD#
#DDDDDDDDDDDDDDDDDTTDDDD#
#DDDDDDD      DDDDTTDDDD#
#DDDDDDD      DDDDTDDDDD#
#DDDDDDD      DDDDTDDDDD#
#DDDDDDD      DDDTTTDDDD#
#DDDDDDD      DDDTTTDDDD#
#DDDDDDDDDDDDDDDDTTDDDDD#
#D        DDDDDDDTTDDDDD#
#D        DDDDDDDTTDDDDD#
#D        DDD    DTD    #
#D        DDD    DTTT   #
#D        DDD    D DT   #
#DDDDDDDDDDDDDDDDD DTT  #
#DD                D T  #
#D  DDDDDDDDDDDDDDTTTTTT#
#DD               TTT TT#
#######################T#
