#T#############
#TTTTTTT      #
#### ##T##  # #
#      T#   # #
# #####T   ## #
# #D   T      #
# ###  T### D #
# #   #T#   # #
# # ###T#   # #
# # #  T# #   #
#   ###T# # ###
# D    T    # #
# #####T #  # #
#      TTTTTTT#
#############T#
