#S#############
#TTT          #
# #T## D# #   #
#D T    # # # #
###T# ##  ##  #
# TT  # #     #
###T#   ##  # #
# #T# # #     #
# #T# # # ##D##
#  T    #     #
##TT  # #   # #
# #TTTTT D# # #
# #### T #  # #
#    D TTTTTTT#
#############T#
