#T#####
#TTT  #
###T# #
# #T  #
#  T###
# TTTT#
#####T#
