#T#######################
#TTTTT             DDDDD#
#TTDTDDDDTDDDDDDDD DDDDD#
#TTTTT TTT DDDDDDD DDDDD#
#TTTTTTTTTTDDDDDDD DDDDD#
#D T TTT   DDDDDDD DDDDD#
#D  TTTT   DDDDDDD DDDDD#
#D TTTT    DDDDDDD DDDDD#
#DDDDTTDDDDDDDDDDD DDDDD#
#DDDDTTT T    DDDD DDDDD#
#DDDDDDTTT    DDDD DDDDD#
#DDDDDDDTT    DDDD DDDDD#
#DDDDDDDT     DDDD DDDDD#
#DDDDDDDTT    DDDD DDDDD#
#DDDDDDDTTTTDDDDDD DDDDD#
#D      TTDTDDDDDD DDDDD#
#D        DTDDDDDD DDDDD#
#D        DTD    D D    #
#D        DTT    D D    #
#D        DTT    D D    #
#DDDDDDDDDDDTDDDDD D    #
#DD         TTTT   D    #
#D  DDDDDDDDTTTTTTTDTTTD#
#DD         TTTTTTTTT TT#
#######################T#
