#M###################################################################################################
#MMMDDDDDDDDDDDD#DDDDDDDDDDDDDDDDDDD#DDDDDDDDDDDDDDDDDDDDDDDDDDDDDDDDDDDDDDDDD#DDDDDDDDDDDDDDDDDDDDD#
#M#T#D#D##D##D#DDD##DD##D####DDDDD###D#D#####DD#D##DD####D#D###D###D#D##DD#D#D#D#DD##D#DD##D#D###D###
#D#TDD#DDDDD#D#DDDDDDDDD#DDDDDDD#DDDDDDDDDDDDD#DDDDD#DDDDD#DDD#DDD#D#DDD#DDD#D#D#DDD#DDDDDDDDDDDDDDD#
#DDT###DD#DDDD#DD###DDDD#D##D#DDDD#####D##DD#D#D###D#D#D#DDDDD###D#D###DD##D#DDD#D#D#D###D#D#######D#
#D#TDD#DDD#D#DDD#DDD#DDDDDDDDDDD#DDD#DDDDD#DDD#DDD#DDD#D#D#D#DDD#DDDDD#D#DDDDD#DDDDD#DDD#DDD#DDDDDDD#
#D#T#D#D#D#D##D#DD#D#DDDDDD#DDDDDD#D#####DDD###D#D#D###D#D#D##DD##D##D#D#DDD#D#####D##DDD##DDD#D#####
#DDT#DDD#DDD#DDD#DDDDD#DDDDD#DDDDDDD#DDD#DDD#DDDDDDDDD#DDDDDDD#DDDDDDD#D#DDDDDDDDDDD#D#DDD#DDD#DDDDD#
#D#TD##D####DD#D#D#DD##DDD#D#D#####DDDDD###D#DDD#D###DD#DDD##D###D#DDDDD#D#D#D###D###D###DD##DDDDD#D#
#D#TTTDDDDDDDD#D#DDDDD#D#DDD#DDDDDDDDD#DDD#DDDDDDDDD#D#DDDDD#DDDDD#DDD#D#DDDDDDDDDDDDDDDDDDDDDDD#DDD#
#D###T#####DDDDD##DDDD#DD##DD####D#D#####D#####D###D#D#D###D#D#####D###D#D###D##DD#DDD###D###DDD#DD##
#D#DDT#DDD#DDD#DDDDD#DDDDD#DDDDD#DDDDDDD#DDDDDDD#D#DDDDD#D#DDDDDDDDD#D#DDD#DDD#DDD#DDDDDDDDDDDDD#DDD#
#D#D#T#D#DDD#D#DD#D#DD#D#DD##D##DDDD###D#D#DD#DDDDDD##DD#DDDD##D#####DD#DD#D###D#DD##DD####D#D##D#DD#
#D#D#TDD#D#DDD#D#DDDDDDD#DDD#DDDDD#DDDDDDDDD#DDDDDDD#DDDDDDDDDDDDDDDDD#DDD#DDD#D#D#DDDDD#D#DDDDDDD#D#
###D#T###D#D#D#D#D#DDD###D#D#D#D#DDDD##D####DD#D#####D#####D#D#DDD#D#D##DD###D#DDDDD##DDDD####DD#D#D#
#DDD#TTT#DDD#DDD#DDDDD#DDDDDDDDD#D#DDDDD#DDDDDDDDDDDDDDDDDDD#D#D#DDD#DDDDDDDDDDD#DDDDD#DDDDDDDDDDDDD#
#D#D###TD#DD###D#D#D#D#D#DD##D###DDD##D##D#D##DDDD##D#DD###D#D#D#D#D#DD###DD#########D#DDD#DD##DD##D#
#D#DDD#TDD#DDD#D#D#DDDDDDDDDDD#D#DDDDDDDDD#DDD#DDDDDDDDDDDDD#D#D#D#DDDDD#DDD#DDDDDDD#D#D#D#DDD#DDDDD#
#D#####TDDD##DD##D#D####DDD#D#DD#D###D###D###D###D#DDD#D#####D#D###D###D#D##DD#D##DD#D#D#D#DDD####DD#
#DDDDDDTDDDDDDDDDD#DDDDD#DDDDDDD#D#DDDDDDDDD#DDD#DDDDD#DDD#D#D#DDD#DDD#D#D#DDD#D#D#DDD#D#DDDDDDDDDDD#
#D#####T#D#D#D#########DDD#####DDDDD#D#D###D##DDDD##DD###D#D#D#D#D##DD#D#D#DD#DDDD###DDD#####D#D#D###
#DDD#DDTTDDD#DDD#DDDDD#D#DDDDDDD#D#DDDDDDDDDDD#DDDDDDDDDDD#DDDDD#DDDDDDDDDDDDD#D#DDDDD#DDD#DDD#DDDDD#
#D###D##T##D###D#D###DDD#D#DDD###D#D#D#D#D#D#DD####D##D##D#D##DD#D###DDD##D##D#DDD#D#D###D#D##DD#DDD#
#D#DDDDDTTTTTTDDDDDDDDDD#D#D#DDD#D#DDDDD#DDDDDDD#DDDDDDD#DDDDDDDDDDD#D#D#DDDDD#DDDDDDDDD#DDD#DDDDD#D#
###D#D#D#####T#D##DDD####D#D#DDDDD#D#D#DDD######DD#D###D#D#####DD##D#D#DD#D##DDD###DD#DD#D#DDD#D###D#
#DDD#DDD#DDDDT#DDD#D#D#DDD#DDD#D#D#D#DDDDDDDDDDDDDDDDD#D#DDDDDDDDDDD#D#DDDDD#DDDDD#DDDDDDDDDDDDDDD#D#
#D###D###D#D#T##D##DDD#D##D##D###D#D#D#D###D###D#####D#D#D###D#D#D##DDD####D#DDD#####D#DDDD####D#D#D#
#D#DDD#D#D#DDTTTDDDD#DDDDDDD#DDD#DDDDDDDDD#DDD#DDD#DDDDD#DDD#D#DDD#D#DDDDDDD#DDDDDDDDD#DDDDDDDDD#D#D#
#DD##D#D#DDD#D#T##D##D##TD#D###D###D#D###D#D###D#DDD###D###D#D#####D##DDDD##D##D##DD#D#D#DDD###D#D#D#
#DDDDD#DDD#D#D#TTTTTTTTTTTTTTD#DDD#DDD#D#DDD#DDDDDDDDDDD#DDD#DDDDD#DDDDDDD#DDD#DDDDD#D#DDD#D#DDD#D#D#
###D#D###D#DDDDDDD#D#TDD####TD###D##D##D#D##DDDD#####DDD#D###DDD#D#D####DD#D#D#D#D#D#DDD##DD#D#D#D#D#
#DDDDDDD#DDD#DDDDDDD#DDD#DDDTTTTTTTTTTDD#D#DDD#DDDDDDD#D#DDD#DDD#DDDDDDDDDDDDDDD#D#D#DDDDDDD#D#DDD#D#
#D###D#D#D##DDD#D##D#####D###T#D#T###T#DDD#DD##D###D#D#D##DD###D####D#D####D#D#DDDDDDD#D#D##DD#D###D#
#DDD#D#DDDDDDDDD#DDD#DDDDDDDDDDDDD#DDT#DDD#D#DDDDD#D#D#DDD#DDD#D#D#DDDDDDDDD#D#DDD#DDD#DDDDDDD#D#DDD#
###D#DDD###D###D#DD##DD####D#D#D##DD#T###DDDD##D###D#D#D#D###D#D#D#D##D###DD###DD##D#D#D###D#D#DD##D#
#DDD#D#DDDDDDDDD#DDD#D#DDDDD#DDDDD#D#TTDDD#DDD#DDDDD#D#DDD#DDD#DDDDD#DDDDDDDDDDDDD#DDD#DDDDD#D#DDD#D#
#DDD#D#DD#D##D#DD#DDDDDD#########D#D##T#D###DD###DD##D#D###DDD####DDDD###D#######D#DD#D###DD#D#DDD#D#
#DDDDD#DDDDDDD#DDDDD#D#DDDDDDDDD#D#DDDTTTTTT#DDDDDDDDDDD#DDDDDDDDDDD#D#DDDDD#DDD#DDD#DDD#DDD#DDD#D#D#
#D#D#D#D###D###D#####D#D#####D#DDD#D##T##DTT#D#D#D##D####D#D###D#D###D#D##DD#D#D#D###DD##D##D##D#DDD#
#DDD#D#D#DDD#DDD#DDD#D#DDDDDDD#DDD#DDD#DDD#T#D#D#DDDDDDD#D#DDDDD#D#DDD#DDDDD#DDDDD#D#DDDDD#DDDDD#DDD#
#DD##DDDDDD##D#D#D##DD#D#D###D####D#DD#D###TTD#D##D###DD#D#######DDD###DDD##DD#D#DDDDD#D###D#D#####D#
#DDDDD#D#DDDDD#DDDDDDD#DDDDDDDDD#DDD#DDDDDDDTDDD#DDDDDDD#D#DDDDD#D#DDD#D#D#DDD#D#DDD#DDDDD#D#DDDDDDD#
#DDDDD#D#######D###D#D#D#D#D#D#D#D#DD###DDD#TTTTD##D##DD#D#D###D#D#D#D#DDD#DD##DDD#D#####DDD###DDDDD#
#DDDDDDDDDDDDD#DDD#DDDDD#DDD#DDD#D#DDD#DDD#DTD#TDD#DDDDDDDDD#D#DDD#D#DDD#DDD#DDD#D#DDDDD#DDDDDDD#DDD#
#D##DD#D###DD####D###D##DDD#####DDD##D#D###D###T#D#####DDDDDDD##DD#DDDD##DDD#####DDD###D##DDD##DDDD##
#DDDDDDDDDDDDDDD#DDD#DDDDD#DDDDDDD#DDD#D#D#DDDDTTDDD#DDD#D#DDD#DDD#DDD#DDD#DDD#DDDDD#DDDDDDD#DDD#DDD#
#DD##DDD#D#D#D#####DD#D####DDD##DDDD#D#D#D#####TTT#DDD#DD##D#D#D#DDDD##DDDD#DDDDD##D#DD#DD#D#D#####D#
#D#DDD#D#DDD#DDDDD#DDD#DDDDDDD#DDD#D#DDD#DDD#DDD#TTTDD#DDDDDDDDDDD#DDD#DDDDDDDDDDD#DDDDDDDDDDDDD#DDD#
#D#D#D#D###D###D#DD##DDD##D##D##DD#D#DD##D#D#DD##D#TTT#####D####DD###D#DDDDD#DDD#DDD#D#D########DD#D#
#D#D#D#D#DDDDDDDDDDD#DDD#DDD#DDDDD#D#DDDDD#DDD#DDD#D#TTD#D#D#DDDDDDDDD#DDD#DDDDDDD#D#DDDDD#DDDDDDD#D#
#D#D#DDD#D##DD###D#D####DD#D####DD#DDD#D###D#D#DD##D##TT#DDD#D####D##DDD#DD##DDD######D##D#D#DDD#####
#DDD#D#D#D#DDD#DDD#DDDDDDD#DDD#DDDDDDD#DDD#D#D#DDDDDDD#TTT#DDD#DDDDDDD#D#DDDDD#DDDDDDDDD#D#D#DDD#DDD#
#D###DDD#D#D#D##D#DD#D#D####DD#D#DDDDD###D#DDD#D#D#DD####T#####DD####D#D#D###D#D#D#D###D###D###D#D###
#DDD#D#DDD#D#DDDDDDD#D#D#DDD#DDDDD#D#DDDDDDDDDDD#D#D#DDDDTTTTTTD#DDD#DDD#D#DDDDDDDDD#DDD#DDD#DDDDD#D#
###D#D#D###DDD####D##D#D#D#D#DD####DDD##D###D####D###D#D#####T#D###D#DD#DDDD#D#D#DDD#D##DD##D#DD#D#D#
#DDD#D#DDDDD#D#DDDDDDD#D#DDDDD#DDDDD#DDDDD#DDDDD#DDDDD#DDDDD#TDDDD#DDDDDDDDD#DDDDDDDDDDDDD#DDDDDDDDD#
###D#D#D#D#D#D#DD#####DD#D##D##D###DD##D#D#D##DD#D#D#D#DD##D#T###D#D###D##DD#D#D#D###D#D#D#D###D##DD#
#DDDDD#DDD#DDD#DDDDDDDDD#DDDDDDDDD#DDDDD#DDD#DDD#DDDDD#D#DDD#TDDDD#D#DDDDD#D#DDD#D#DDD#D#D#D#D#D#DDD#
#D#######D#D#D#DD#D####D#D#######DDD###D#####D#D#DD####DDD##DT#D###D#D###DDDD####D#D###D#D#DDD#D#D###
#DDDDDDDDD#DDD#DDD#DDDDDDDDDDD#DDDDDDDDD#DDDDD#DDD#DDDDD#DDDDT#DDDDDDDDD#D#DDDDDDD#D#DDD#D#DDD#DDDDD#
###DD###D##DDD##DDDD#D###D###D#D#D###DDD#D#########D######DD#T#D#DDDD#D##D#D######DDDD#D###D##DDDD#D#
#DDD#DDD#DDDDDDDDDDD#DDDDDDDDDDD#DDDDDDD#DDD#DDDDDDDDDDDDDDD#TDDDDDD#DDDDD#DDDDDDDDDDDDD#DDD#DDD#DDD#
#D#DDDDD#D##DDDD#####D#DD###D##############DDD#######DD##DDD#T##D##DDD#####D#D#DDDD#D#DD#D###D#DD##D#
#DDDDDDDDD#DDD#DDDDD#D#DDDDDDDDDDDDDDD#DDDDDDDDDDDDD#D#DDD#D#TTT#DDD#D#DDDDD#DDDDDDDDDDD#D#DDDDDDD#D#
#D#########D#D###D###D#D##D##DDD##D##D#D####D#D####D#D#D###D###T#####D#DDD######DD###D###DDD##D##D#D#
#D#DDDDDDDDD#DDD#DDD#DDDDDDD#D#D#D#DDD#DDDDDDDDDDDDDDD#DDDDDDD#T#DDDDD#DDD#DDDDD#D#DDDDD#DDDDDDDDDDD#
#DDDD##D#DD####D#DDD#D##D##D#D#D#D#DDDD##D#D###D###DDDD####D###TDD##D##D#####D#D#DDD#####D#D###D#####
#DDD#D#DDD#DDD#DDD#DDDDDDD#D#DDDDD#D#DDDDD#DDDDDDDDD#DDDDDDDDD#T#D#DDD#D#DDDDD#D#DDD#DDDDDDD#D#DDDDD#
##D#DD##DD#D##DDDD#D##D##D#D######DD#D#D####DD#DDD#D#DDDDD#DDD#TDDDD#DDD#D#D#DDD#D#DDD#D##D##D##D##D#
#DDDDD#DDDDD#DDD#D#D#DDDDDDD#DDDDDDDDDDD#DDDDD#DDD#D#DDD#DDD#DDTTDDD#DDD#DDDDD#D#DDD#D#DDD#DDDDD#DDD#
#D#D#D#DDD#D#D#DD#DD#D##DD###D#D#D#DD#DD#D#D#D###D#D###D####DD##T##D#D#D#D##D######D#D##DD#D###D#D###
#D#DDD#DDD#DDD#DDDDDDDDDDD#DDDDDDD#DDD#DDD#DDD#DDD#DDD#D#DDDDDDDTTTDDDDD#DDDDDDDDDDDDD#DDD#D#DDD#DDD#
#D#D####DDD####D###D##DD##DD###D#####D#DD#DD###D#D#D#D#D#D#D##D###TD###D#D#D###D#######D#D#D#DDD#D#D#
#D#DDDDD#DDD#DDDDDDDDD#DDDDDDDDD#DDD#D#DDD#DDDDD#D#D#DDD#DDDDD#DDDTTTTTDDD#DDDDDDDDDDDDD#DDD#D#DDDDD#
#D#########D#D###D#D#D####D##D#D#D#D#D###D#D#D###D####D######D#D######TT##DD#D#DD###DD#DDD###D###D###
#DDDDD#DDDDDDDDD#DDDDD#DDDDDDD#D#D#D#DDD#D#D#D#D#D#DDD#DDDDD#D#D#DDDDD#TDDDDDDDD#DDDDDDDDDDD#DDDDDDD#
#####D#D###DDD#D#D#D##DD#DD##D##DD#DD#DDDD##DDDD#D#DDD#D#DDDDDDDDD#D#D#T###D###D#D########DD#D#D#DDD#
#DDDDD#DDDDDDDDDDDDDDDDDDD#DDD#DDD#DDD#DDD#DDD#D#DDD#DDDDDDDDDDDDDDD#D#T#D#DDDDD#D#DDDDD#D#D#DDD#D#D#
#D#####D##DD#D#D#DDD#D#D#D#DDD#D#D###D###D#DD##D##DD####DD#DDD###D###D#T#T##DD###D#D###D#DDD#DDD#DDD#
#DDDDDDDDDDD#DDD#D#D#D#DDDDDDDDD#DDDDDDDDD#D#DDDDD#DDDDDDDDD#D#DDD#DDDDTTTTT#DDDDD#DDD#D#D#D#DDDDDDD#
##D#D##DD#DD#DDD#D#D#D###D#######D#DD#D#DD#D##DDDD#D#DD#DD#D#D#D#D#D##D####TDD##D##DDD#D#D#D#DD####D#
#DDD#DDDDD#DDD#D#DDD#DDDDD#DDDDDDD#D#DDDDD#DDDDD#DDDDDDDDDDD#D#DDD#D#DDD#DDT#DDDDDDDDD#D#DDD#DDDDD#D#
#D#DDDD#DD#DDD#DD####D#D#D#D##D##DDDDD###D#D####D##DDD#D###D#DDD#D##DDDD#D#T###D##D#D##D######D#DD#D#
#D#DDD#D#DDD#DDDDDDD#DDDDD#DDD#DDDDD#D#DDD#DDDDD#DDD#DDD#DDD#DDDDD#DDDDDDD#TDD#DDD#DDDDDDDDDDDDD#DDD#
#D#D#D#D#D#DDD#####DDDDD#D##DD##D##D#DDD##DDDD#D##D##D#D#D#####D#DDD####D##TDD###D#D#DD###D##D#D##D##
#D#DDD#DDD#DDD#DDDDD#D#DDDDDDDDDDD#DDD#D#DDD#D#DDD#DDD#DDDDD#DDDDD#D#D#DDDTT#D#D#DDDDD#DDDDDDD#D#DDD#
#D##D##D####DD#D#DDD#D#DDD#D#D#D#D####DD#D##DD###D#DD####DDD#D#####D#D#D#D#T#D#D##D##D#D####DD#DD#DD#
#DDDDD#DDDDD#D#DDDDDDDDD#DDD#D#D#DDDDD#D#DDD#D#DDD#DDDDD#D#D#D#DDD#D#DDD#D#T#D#DDDDD#D#D#DDDDDDDDDDD#
#D##DD#D#D#DDD#DD##D#DD###DD#D#D##DDDD#D#DDD#D#DDD#D###D#D#D#DD#DDDD#####D#T#D#D###D#D#D#DDD#D###DDD#
#DDDDDDDDD#DDDDDDD#DDDDD#DDDDD#DDDDD#DDDDD#D#D#DDDDD#DDD#D#DDD#DDDDD#DDDDD#TDD#DDD#D#D#DDD#DDDDDDDDD#
###D#####DD###DD###D##DD#D#DDD#####DDD#D#D#D#D##DD#D#D#D#D#####DDDDDDD#D#D#T###DDDDD#D###DDDDDDD#D#D#
#DDD#DDD#D#DDDDD#DDD#D#D#D#D#DDDDD#DDDDD#DDD#D#DDDDD#DDD#D#DDDDD#D#DDD#DDD#TTT#D#DDDDDDDDD#DDDDD#DDD#
#D###D#D#D#DD####DD##D#D#DDD#D###DD####D#DDD#D#####D###D#D##D##D#######D#D###T#D#D#D#DD###DD#D###DD##
#DDDDD#DDD#DDDDDDDDD#DDDDD#D#DDD#DDDDDDD#DDDDDDDDD#DDDDDDDDDDDDD#DDDDD#D#DDD#TTT#DDD#DDDDD#DDDDDDDDD#
#D#####D#D#D##DDDD#D#D#####D#D#DD#DD###D###D##DD#DDDD##D#DD#DD#D#D#D###D#D#D###T##D##D#D#DDDDDDD###D#
#DDDDDDD#DDD#DDD#DDD#DDD#DDDDDDDDD#D#DDD#DDDDDDDDDDDDD#DDDDDDDDD#DDDDDDDDD#DDD#TTTTTTTTT#DDD#DDD#DDD#
##D##D#D##DD#DD#DD##D##D#D#D##DD#D#D#DD##D##DD#DD##D#D#D##DD##D##D#D#####DD##D#D##D#D##TD######D#D#D#
#DDDDDDD#D#D#DDDDDDDDDDD#DDDDDDDDD#DDD#DDD#DDDDD#D#D#DDDDDDDDD#DDD#DDDDDDD#DDDDD#DDDDD#TTTTT#DDD#DDD#
#D##DD#D#D#D##D##D#D##DD######DDDD###DD##D#DDD#DDD#D###D####D##DDD#####D#D#D###D#D###D#T###T#D##D##D#
#DDDDDDDDDDDDDDDDDDD#DDDDDDDDDDDDDDDDDDDDD#D#DDDDD#DDDDDDDDDDDDDDDDDDDDD#DDD#DDDDDDD#DDDDD#TTTTTTTTT#
###################################################################################################T#
