#T#################################################
#TTTTTTTTTTTTTTTTTTTTTTTTTTTTTTTTTTTDTTDTTTDDDDDDD#
#TTTDTTTTTTDTDTTDDDDDDDDDDDDDTTTTTTTTTTTTTTDDDDDDD#
#DDDDDDTDDDDDDDTDDDDDDDDDDDDDDDDDTTDDTTTTDDDDDDDDD#
#DDDDDDDDDDDDDDDDDDDDDDDDDDDDDDDDDDDDTTTTDDDDDDDDD#
#DDDDDDDDDDDDDDDDDDDDDDDDDDDDDDDDDDDDDDDTDDDDDDDDD#
#DDDDDDDDDDDDDDDDDDDDDDDDDDDDDDDDDDDDDDDTDDDDDDDDD#
#DDDDDDDDDDDDDDDDDDDDDDDDDDDDDDDDDDDDDDDTTTTDDDDDD#
#DDDDDDDDDDDDDDDDDDDDDDDDDDDDDDDDDDDDDDDTTTTDDDDDD#
#DDDDDDDDDDDDDDDDDDDDDDDDDDDDDDDDDDDDDDDDDDTDDDDDD#
#DDDDDDDDDDDDDDDDDDDDDDDDDDDDDDDDDDDDDDDDDDTTDDDDD#
#DDDDDDDDDDDDDDDDDDDDDDDDDDDDDDDDDDDDDDDDDDDTDDDDD#
#DDDDDDDDDDDDDDDDDDDDDDDDDDDDDDDDDDDDDDDDDDDTDDDDD#
#DDDDDDDDDDDDDDDDDDDDDDDDDDDDDDDDDDDDDDDDDDDTDDDDD#
#DDDDDDDDDDDDDDDDDDDDDDDDDDDDDDDDDDDDDDDDDDDTTDDDD#
#DDDDDDDDDDDDDDDDDDDDDDDDDDDDDDDDDDDDDDDDDDDDTDDDD#
#DDDDDDDDDDDDDDDDDDDDDDDDDDDDDDDDDDDDDDDDDDDDTTDDD#
#DDDDDDDDDDDDDDDDDDDDDDDDDDDDDDDDDDDDDDDDDDDDDTTTD#
#DDDDDDDDDDDDDDDDDDDDDDDDDDDDDDDDDDDDDDDDDDDDDDDTT#
#DDDDDDDDDDDDDDDDDDDDDDDDDDDDDDDDDDDDDDDDDDDDDDDDT#
#DDDDDDDDDDDDDDDDDDDDDDDDDDDDDDDDDDDDDDDDDDDDDTTTT#
#DDDDDDDDDDDDDDDDDDDDDDDDDDDDDDDDDDDDDDDDDDDDTTTTD#
#DDDDDDDDDDDDDDDDDDDDDDDDDDDDDDDDDDDDDDDDDDDDTDTDD#
#DDDDDDDDDDDDDDDDDDDDDDDDDDDDDDDDDDDDDDDDDDDDTDDDD#
#DDDDDDDDDDDDDDDDDDDDDDDDDDDDDDDDDDDDDDDDDDDDTTTDD#
#DDDDDDDDDDDDDDDDDDDDDDDDDDDDDDDDDDDDDDDDDDDDDDTDD#
#DDDDDDDDDDDDDDDDDDDDDDDDDDDDDDDDDDDDDDDDDDDDDDTTD#
#DDDDDDDDDDDDDDDDDDDDDDDDDDDDDDDDDDDDDDDDDDDDDDDTT#
#DDDDDDDDDDDDDDDDDDDDDDDDDDDDDDDDDDDDDDDDDDDDDDDDT#
#DDDDDDDDDDDDDDDDDDDDDDDDDDDDDDDDDDDDDDDDDDDDDDDDT#
#DDDDDDDDDDDDDDDDDDDDDDDDDDDDDDDDDDDDDDDDDDDDDDDDT#
#DDDDDDDDDDDDDDDDDDDDDDDDDDDDDDDDDDDDDDDDDDDDDDDDT#
#DDDDDDDDDDDDDDDDDDDDDDDDDDDDDDDDDDDDDDDDDDDDDDDTT#
#DDDDDDDDDDDDDDDDDDDDDDDDDDDDDDDDDDDDDDDDDDDDDDDTD#
#DDDDDDDDDDDDDDDDDDDDDDDDDDDDDDDDDDDDDDDDDDDDDDDTD#
#DDDDDDDDDDDDDDDDDDDDDDDDDDDDDDDDDDDDDDDDDDDDDDTTD#
#DDDDDDDDDDDDDDDDDDDDDDDDDDDDDDDDDDDDDDDDDDDDDDTDD#
#DDDDDDDDDDDDDDDDDDDDDDDDDDDDDDDDDDDDDDDDDDDDDDTTD#
#DDDDDDDDDDDDDDDDDDDDDDDDDDDDDDDDDDDDDDDDDDDDDDDTT#
#DDDDDDDDDDDDDDDDDDDDDDDDDDDDDDDDDDDDDDDDDDDDDDDDT#
#DDDDDDDDDDDDDDDDDDDDDDDDDDDDDDDDDDDDDDDDDDDDDDDDT#
#DDDDDDDDDDDDDDDDDDDDDDDDDDDDDDDDDDDDDDDDDDDDDDDTT#
#DDDDDDDDDDDDDDDDDDDDDDDDDDDDDDDDDDDDDDDDDDDDDDDTT#
#DDDDDDDDDDDDDDDDDDDDDDDDDDDDDDDDDDDDDDDDDDDDDDDTD#
#DDDDDDDDDDDDDDDDDDDDDDDDDDDDDDDDDDDDDDDDDDDDDDDTD#
#DDDDDDDDDDDDDDDDDDDDDDDDDDDDDDDDDDDDDDDDDDDDDDDTT#
#DDDDDDDDDDDDDDDDDDDDDDDDDDDDDDDDDDDDDDDDDDDDDDDDT#
#DDDDDDDDDDDDDDDDDDDDDDDDDDDDDDDDDDDDDDDDDDDDDDDDT#
#DDDDDDDDDDDDDDDDDDDDDDDDDDDDDDDDDDDDDDDDDDDDDDDTT#
#DDDDDDDDDDDDDDDDDDDDDDDDDDDDDDDDDDDDDDDDDDDDDDTTT#
#################################################T#
