#T#############
#TTT          #
# #T## D# #   #
#TTTT   # # # #
###T# ##  ##  #
#  T  # #     #
###T#   ##  # #
# #T# # #     #
# #T# # # ##D##
#  TTT  #     #
##   T# #   # #
# #  TT  D# # #
# ####TTT#TT# #
#    D TTTTTTT#
#############T#
